"state","year","total_days_aqi","total_healthy_days","total_unhealthy_days","percentage_good_days","percentage_bad_days"
"Alabama","2010",5363,5281,82,0.98471005,0.01528995
"Alabama","2011",4722,4639,83,0.982422702,0.017577298
"Alabama","2012",4481,4417,64,0.985717474,0.014282526
"Alabama","2013",4773,4770,3,0.999371464,0.000628536
"Alabama","2014",4688,4672,16,0.996587031,0.003412969
"Alabama","2015",5171,5149,22,0.995745504,0.004254496
"Alabama","2016",5004,4975,29,0.994204636,0.005795364
"Alabama","2017",5276,5253,23,0.995640637,0.004359363
"Alabama","2018",5143,5130,13,0.997472292,0.002527708
"Alabama","2019",5068,5047,21,0.995856354,0.004143646
"Alaska","2010",2097,2056,41,0.980448259,0.019551741
"Alaska","2011",2196,2161,35,0.984061931,0.015938069
"Alaska","2012",2410,2362,48,0.980082988,0.019917012
"Alaska","2013",2274,2207,67,0.9705365,0.0294635
"Alaska","2014",2193,2094,99,0.954856361,0.045143639
"Alaska","2015",2045,1971,74,0.963814181,0.036185819
"Alaska","2016",1997,1937,60,0.969954932,0.030045068
"Alaska","2017",1996,1944,52,0.973947896,0.026052104
"Alaska","2018",2253,2210,43,0.980914336,0.019085664
"Alaska","2019",2480,2421,59,0.976209677,0.023790323
"Arizona","2010",4027,3780,247,0.938664018,0.061335982
"Arizona","2011",4168,3824,344,0.917466411,0.082533589
"Arizona","2012",4375,3977,398,0.909028571,0.090971429
"Arizona","2013",4506,4229,277,0.938526409,0.061473591
"Arizona","2014",4645,4328,317,0.931754575,0.068245425
"Arizona","2015",4670,4436,234,0.949892934,0.050107066
"Arizona","2016",4728,4470,258,0.945431472,0.054568528
"Arizona","2017",4703,4403,300,0.936210929,0.063789071
"Arizona","2018",4733,4491,242,0.948869639,0.051130361
"Arizona","2019",4727,4592,135,0.97144066,0.02855934
"Arkansas","2010",3785,3745,40,0.989431968,0.010568032
"Arkansas","2011",3687,3632,55,0.985082723,0.014917277
"Arkansas","2012",3151,3095,56,0.982227864,0.017772136
"Arkansas","2013",2955,2950,5,0.998307953,0.001692047
"Arkansas","2014",2996,2993,3,0.998998665,0.001001335
"Arkansas","2015",2977,2975,2,0.999328183,0.000671817
"Arkansas","2016",3022,3018,4,0.998676373,0.001323627
"Arkansas","2017",3022,3020,2,0.999338187,0.000661813
"Arkansas","2018",3120,3111,9,0.997115385,0.002884615
"Arkansas","2019",3088,3086,2,0.999352332,0.000647668
"California","2010",18566,17182,1384,0.925455133,0.074544867
"California","2011",18665,16931,1734,0.907098848,0.092901152
"California","2012",18879,17072,1807,0.904285185,0.095714815
"California","2013",18694,17177,1517,0.918850968,0.081149032
"California","2014",18600,17002,1598,0.914086022,0.085913978
"California","2015",18585,17158,1427,0.923217649,0.076782351
"California","2016",18998,17454,1544,0.918728287,0.081271713
"California","2017",18936,17140,1796,0.905154204,0.094845796
"California","2018",19038,17193,1845,0.90308856,0.09691144
"California","2019",19063,18191,872,0.954256938,0.045743062
"Colorado","2010",8804,8631,173,0.980349841,0.019650159
"Colorado","2011",9125,8828,297,0.967452055,0.032547945
"Colorado","2012",9058,8661,397,0.95617134,0.04382866
"Colorado","2013",9130,8897,233,0.974479737,0.025520263
"Colorado","2014",9067,8973,94,0.989632734,0.010367266
"Colorado","2015",8988,8878,110,0.98776146,0.01223854
"Colorado","2016",9220,9133,87,0.990563991,0.009436009
"Colorado","2017",9371,9261,110,0.988261658,0.011738342
"Colorado","2018",9701,9409,292,0.96990001,0.03009999
"Colorado","2019",8043,7986,57,0.992913092,0.007086908
"Connecticut","2010",2507,2412,95,0.962106103,0.037893897
"Connecticut","2011",2247,2179,68,0.969737428,0.030262572
"Connecticut","2012",2518,2389,129,0.948768864,0.051231136
"Connecticut","2013",2520,2441,79,0.968650794,0.031349206
"Connecticut","2014",2529,2473,56,0.97785686,0.02214314
"Connecticut","2015",2541,2447,94,0.96300669,0.03699331
"Connecticut","2016",2529,2445,84,0.966785291,0.033214709
"Connecticut","2017",2579,2523,56,0.978286157,0.021713843
"Connecticut","2018",2552,2487,65,0.974529781,0.025470219
"Connecticut","2019",2601,2541,60,0.976931949,0.023068051
"Country Of Mexico","2010",792,737,55,0.930555556,0.069444444
"Country Of Mexico","2011",725,653,72,0.900689655,0.099310345
"Country Of Mexico","2012",732,676,56,0.923497268,0.076502732
"Country Of Mexico","2013",727,670,57,0.921595598,0.078404402
"Country Of Mexico","2014",265,252,13,0.950943396,0.049056604
"Country Of Mexico","2015",56,42,14,0.75,0.25
"Country Of Mexico","2016",276,222,54,0.804347826,0.195652174
"Country Of Mexico","2017",570,494,76,0.866666667,0.133333333
"Country Of Mexico","2018",514,472,42,0.918287938,0.081712062
"Country Of Mexico","2019",390,377,13,0.966666667,0.033333333
"Delaware","2010",976,910,66,0.932377049,0.067622951
"Delaware","2011",1095,1056,39,0.964383562,0.035616438
"Delaware","2012",1074,1015,59,0.945065177,0.054934823
"Delaware","2013",1087,1076,11,0.989880405,0.010119595
"Delaware","2014",1094,1080,14,0.987202925,0.012797075
"Delaware","2015",1095,1082,13,0.988127854,0.011872146
"Delaware","2016",1096,1081,15,0.986313869,0.013686131
"Delaware","2017",1091,1078,13,0.988084326,0.011915674
"Delaware","2018",1095,1083,12,0.989041096,0.010958904
"Delaware","2019",1095,1092,3,0.997260274,0.002739726
"District Of Columbia","2010",365,330,35,0.904109589,0.095890411
"District Of Columbia","2011",365,349,16,0.956164384,0.043835616
"District Of Columbia","2012",366,338,28,0.923497268,0.076502732
"District Of Columbia","2013",365,364,1,0.997260274,0.002739726
"District Of Columbia","2014",365,361,4,0.989041096,0.010958904
"District Of Columbia","2015",365,360,5,0.98630137,0.01369863
"District Of Columbia","2016",366,359,7,0.980874317,0.019125683
"District Of Columbia","2017",365,361,4,0.989041096,0.010958904
"District Of Columbia","2018",365,359,6,0.983561644,0.016438356
"District Of Columbia","2019",365,360,5,0.98630137,0.01369863
"Florida","2010",13213,13109,104,0.992128964,0.007871036
"Florida","2011",13562,13412,150,0.988939684,0.011060316
"Florida","2012",13939,13863,76,0.994547672,0.005452328
"Florida","2013",13463,13430,33,0.997548838,0.002451162
"Florida","2014",13944,13894,50,0.996414228,0.003585772
"Florida","2015",14026,14004,22,0.998431484,0.001568516
"Florida","2016",13926,13906,20,0.998563837,0.001436163
"Florida","2017",13866,13823,43,0.996898889,0.003101111
"Florida","2018",13952,13917,35,0.997491399,0.002508601
"Florida","2019",13778,13758,20,0.998548411,0.001451589
"Georgia","2010",9512,9369,143,0.984966358,0.015033642
"Georgia","2011",9460,9188,272,0.971247357,0.028752643
"Georgia","2012",9495,9362,133,0.985992628,0.014007372
"Georgia","2013",9520,9480,40,0.995798319,0.004201681
"Georgia","2014",9422,9376,46,0.995117809,0.004882191
"Georgia","2015",9449,9411,38,0.99597841,0.00402159
"Georgia","2016",9170,9060,110,0.988004362,0.011995638
"Georgia","2017",8580,8561,19,0.997785548,0.002214452
"Georgia","2018",8311,8287,24,0.997112261,0.002887739
"Georgia","2019",8545,8500,45,0.994733762,0.005266238
"Hawaii","2010",1073,728,345,0.678471575,0.321528425
"Hawaii","2011",1324,1051,273,0.793806647,0.206193353
"Hawaii","2012",1444,1104,340,0.764542936,0.235457064
"Hawaii","2013",1457,1153,304,0.791352093,0.208647907
"Hawaii","2014",1403,1132,271,0.80684248,0.19315752
"Hawaii","2015",1457,1153,304,0.791352093,0.208647907
"Hawaii","2016",1456,1144,312,0.785714286,0.214285714
"Hawaii","2017",1457,1156,301,0.793411119,0.206588881
"Hawaii","2018",1446,1276,170,0.882434302,0.117565698
"Hawaii","2019",1457,1453,4,0.997254633,0.002745367
"Idaho","2010",4999,4946,53,0.98939788,0.01060212
"Idaho","2011",5409,5361,48,0.991125901,0.008874099
"Idaho","2012",5147,5036,111,0.978434039,0.021565961
"Idaho","2013",3958,3869,89,0.977513896,0.022486104
"Idaho","2014",3658,3607,51,0.986057955,0.013942045
"Idaho","2015",5964,5795,169,0.971663313,0.028336687
"Idaho","2016",6804,6731,73,0.989271017,0.010728983
"Idaho","2017",7022,6761,261,0.962831102,0.037168898
"Idaho","2018",7213,7097,116,0.983917926,0.016082074
"Idaho","2019",7241,7214,27,0.996271233,0.003728767
"Illinois","2010",8945,8782,163,0.981777529,0.018222471
"Illinois","2011",8722,8564,158,0.981884889,0.018115111
"Illinois","2012",8719,8322,397,0.954467255,0.045532745
"Illinois","2013",8537,8470,67,0.99215181,0.00784819
"Illinois","2014",8516,8446,70,0.991780178,0.008219822
"Illinois","2015",8607,8566,41,0.995236435,0.004763565
"Illinois","2016",8708,8624,84,0.990353698,0.009646302
"Illinois","2017",8906,8838,68,0.992364698,0.007635302
"Illinois","2018",9313,9209,104,0.988832814,0.011167186
"Illinois","2019",9088,9056,32,0.996478873,0.003521127
"Indiana","2010",11641,11373,268,0.976977923,0.023022077
"Indiana","2011",11444,11162,282,0.975358266,0.024641734
"Indiana","2012",11550,11084,466,0.95965368,0.04034632
"Indiana","2013",11883,11790,93,0.992173694,0.007826306
"Indiana","2014",12562,12406,156,0.987581595,0.012418405
"Indiana","2015",12763,12675,88,0.993105069,0.006894931
"Indiana","2016",11902,11787,115,0.990337758,0.009662242
"Indiana","2017",12357,12299,58,0.995306304,0.004693696
"Indiana","2018",13464,13344,120,0.991087344,0.008912656
"Indiana","2019",13307,13283,24,0.998196438,0.001803562
"Iowa","2010",5430,5351,79,0.985451197,0.014548803
"Iowa","2011",5403,5362,41,0.992411623,0.007588377
"Iowa","2012",5450,5359,91,0.983302752,0.016697248
"Iowa","2013",5546,5471,75,0.98647674,0.01352326
"Iowa","2014",5560,5479,81,0.985431655,0.014568345
"Iowa","2015",5582,5556,26,0.995342171,0.004657829
"Iowa","2016",5601,5589,12,0.997857525,0.002142475
"Iowa","2017",4997,4994,3,0.99939964,0.00060036
"Iowa","2018",4613,4596,17,0.996314763,0.003685237
"Iowa","2019",4610,4608,2,0.999566161,0.000433839
"Kansas","2010",4328,4292,36,0.99168207,0.00831793
"Kansas","2011",3942,3849,93,0.976407915,0.023592085
"Kansas","2012",3849,3664,185,0.951935568,0.048064432
"Kansas","2013",3609,3597,12,0.996674979,0.003325021
"Kansas","2014",3428,3414,14,0.995915986,0.004084014
"Kansas","2015",3420,3415,5,0.998538012,0.001461988
"Kansas","2016",3463,3458,5,0.998556165,0.001443835
"Kansas","2017",3622,3619,3,0.999171728,0.000828272
"Kansas","2018",3729,3724,5,0.998659158,0.001340842
"Kansas","2019",3693,3688,5,0.998646087,0.001353913
"Kentucky","2010",9432,9230,202,0.978583545,0.021416455
"Kentucky","2011",9036,8870,166,0.981629039,0.018370961
"Kentucky","2012",8862,8482,380,0.957120289,0.042879711
"Kentucky","2013",8953,8932,21,0.997654418,0.002345582
"Kentucky","2014",8861,8819,42,0.995260129,0.004739871
"Kentucky","2015",8699,8650,49,0.994367169,0.005632831
"Kentucky","2016",8818,8770,48,0.994556589,0.005443411
"Kentucky","2017",8770,8754,16,0.998175599,0.001824401
"Kentucky","2018",8564,8534,30,0.996496964,0.003503036
"Kentucky","2019",8716,8701,15,0.998279027,0.001720973
"Louisiana","2010",7387,7144,243,0.967104373,0.032895627
"Louisiana","2011",7446,7159,287,0.961455815,0.038544185
"Louisiana","2012",7459,7332,127,0.982973589,0.017026411
"Louisiana","2013",7498,7436,62,0.991731128,0.008268872
"Louisiana","2014",7373,7315,58,0.99213346,0.00786654
"Louisiana","2015",6935,6890,45,0.993511175,0.006488825
"Louisiana","2016",7241,7213,28,0.996133131,0.003866869
"Louisiana","2017",7582,7557,25,0.996702717,0.003297283
"Louisiana","2018",7625,7585,40,0.994754098,0.005245902
"Louisiana","2019",7598,7584,14,0.99815741,0.00184259
"Maine","2010",3687,3661,26,0.992948196,0.007051804
"Maine","2011",3287,3271,16,0.99513234,0.00486766
"Maine","2012",3292,3283,9,0.9972661,0.0027339
"Maine","2013",3373,3349,24,0.992884672,0.007115328
"Maine","2014",3368,3362,6,0.998218527,0.001781473
"Maine","2015",3581,3573,8,0.997765987,0.002234013
"Maine","2016",3671,3665,6,0.998365568,0.001634432
"Maine","2017",3556,3542,14,0.996062992,0.003937008
"Maine","2018",3320,3313,7,0.997891566,0.002108434
"Maine","2019",3320,3316,4,0.998795181,0.001204819
"Maryland","2010",4739,4435,304,0.935851445,0.064148555
"Maryland","2011",4561,4331,230,0.949572462,0.050427538
"Maryland","2012",4698,4454,244,0.948063006,0.051936994
"Maryland","2013",4688,4646,42,0.991040956,0.008959044
"Maryland","2014",4970,4947,23,0.995372233,0.004627767
"Maryland","2015",5047,4988,59,0.988309887,0.011690113
"Maryland","2016",5081,4987,94,0.981499705,0.018500295
"Maryland","2017",5568,5477,91,0.983656609,0.016343391
"Maryland","2018",5640,5558,82,0.985460993,0.014539007
"Maryland","2019",5646,5588,58,0.989727241,0.010272759
"Massachusetts","2010",3923,3841,82,0.979097629,0.020902371
"Massachusetts","2011",3957,3899,58,0.985342431,0.014657569
"Massachusetts","2012",3903,3822,81,0.979246733,0.020753267
"Massachusetts","2013",4098,4050,48,0.988286969,0.011713031
"Massachusetts","2014",4698,4694,4,0.999148574,0.000851426
"Massachusetts","2015",4578,4552,26,0.994320664,0.005679336
"Massachusetts","2016",4719,4688,31,0.993430812,0.006569188
"Massachusetts","2017",4703,4663,40,0.991494791,0.008505209
"Massachusetts","2018",4720,4685,35,0.992584746,0.007415254
"Massachusetts","2019",4714,4709,5,0.99893933,0.00106067
"Michigan","2010",6743,6630,113,0.98324188,0.01675812
"Michigan","2011",6862,6679,183,0.97333139,0.02666861
"Michigan","2012",7179,6657,522,0.927287923,0.072712077
"Michigan","2013",7418,7354,64,0.991372338,0.008627662
"Michigan","2014",7904,7827,77,0.990258097,0.009741903
"Michigan","2015",8112,8041,71,0.991247535,0.008752465
"Michigan","2016",8129,7957,172,0.978841186,0.021158814
"Michigan","2017",8684,8633,51,0.99412713,0.00587287
"Michigan","2018",8603,8489,114,0.986748809,0.013251191
"Michigan","2019",8437,8413,24,0.997155387,0.002844613
"Minnesota","2010",6153,6113,40,0.993499106,0.006500894
"Minnesota","2011",6104,6080,24,0.996068152,0.003931848
"Minnesota","2012",6243,6222,21,0.996636233,0.003363767
"Minnesota","2013",6116,6110,6,0.999018967,0.000981033
"Minnesota","2014",6574,6568,6,0.999087314,0.000912686
"Minnesota","2015",6655,6633,22,0.996694215,0.003305785
"Minnesota","2016",6710,6697,13,0.998062593,0.001937407
"Minnesota","2017",6773,6772,1,0.999852355,0.000147645
"Minnesota","2018",6923,6909,14,0.997977755,0.002022245
"Minnesota","2019",7036,7027,9,0.998720864,0.001279136
"Mississippi","2010",3831,3785,46,0.987992691,0.012007309
"Mississippi","2011",3800,3767,33,0.991315789,0.008684211
"Mississippi","2012",3435,3394,41,0.988064047,0.011935953
"Mississippi","2013",3122,3116,6,0.998078155,0.001921845
"Mississippi","2014",3076,3059,17,0.994473342,0.005526658
"Mississippi","2015",3254,3252,2,0.999385372,0.000614628
"Mississippi","2016",3189,3188,1,0.999686422,0.000313578
"Mississippi","2017",3238,3236,2,0.999382335,0.000617665
"Mississippi","2018",3401,3388,13,0.996177595,0.003822405
"Mississippi","2019",3378,3376,2,0.999407934,0.000592066
"Missouri","2010",6190,5952,238,0.961550889,0.038449111
"Missouri","2011",6265,5981,284,0.954668795,0.045331205
"Missouri","2012",6405,5909,496,0.9225605,0.0774395
"Missouri","2013",6484,6376,108,0.983343615,0.016656385
"Missouri","2014",6459,6366,93,0.985601486,0.014398514
"Missouri","2015",6733,6671,62,0.990791623,0.009208377
"Missouri","2016",6866,6829,37,0.994611127,0.005388873
"Missouri","2017",7578,7557,21,0.99722882,0.00277118
"Missouri","2018",7419,7301,118,0.984094891,0.015905109
"Missouri","2019",7402,7120,282,0.961902189,0.038097811
"Montana","2010",5440,5335,105,0.980698529,0.019301471
"Montana","2011",5141,5060,81,0.98424431,0.01575569
"Montana","2012",5297,5167,130,0.975457806,0.024542194
"Montana","2013",5687,5636,51,0.991032179,0.008967821
"Montana","2014",5833,5783,50,0.991428082,0.008571918
"Montana","2015",5888,5717,171,0.97095788,0.02904212
"Montana","2016",5891,5833,58,0.990154473,0.009845527
"Montana","2017",5830,5583,247,0.957632933,0.042367067
"Montana","2018",5888,5785,103,0.982506793,0.017493207
"Montana","2019",5861,5850,11,0.998123187,0.001876813
"Nebraska","2010",2311,2295,16,0.99307659,0.00692341
"Nebraska","2011",2406,2400,6,0.997506234,0.002493766
"Nebraska","2012",2436,2403,33,0.986453202,0.013546798
"Nebraska","2013",2259,2252,7,0.996901284,0.003098716
"Nebraska","2014",2215,2211,4,0.998194131,0.001805869
"Nebraska","2015",2299,2294,5,0.997825141,0.002174859
"Nebraska","2016",2134,2127,7,0.996719775,0.003280225
"Nebraska","2017",2214,2209,5,0.997741644,0.002258356
"Nebraska","2018",2230,2226,4,0.998206278,0.001793722
"Nebraska","2019",2213,2213,0,1,0
"Nevada","2010",2909,2869,40,0.98624957,0.01375043
"Nevada","2011",2997,2933,64,0.978645312,0.021354688
"Nevada","2012",2580,2481,99,0.961627907,0.038372093
"Nevada","2013",2895,2780,115,0.960276339,0.039723661
"Nevada","2014",2951,2906,45,0.984750932,0.015249068
"Nevada","2015",3027,2975,52,0.982821275,0.017178725
"Nevada","2016",3209,3170,39,0.987846681,0.012153319
"Nevada","2017",3228,3178,50,0.984510533,0.015489467
"Nevada","2018",3217,3108,109,0.966117501,0.033882499
"Nevada","2019",3252,3245,7,0.997847478,0.002152522
"New Hampshire","2010",2398,2278,120,0.949958299,0.050041701
"New Hampshire","2011",2392,2321,71,0.970317726,0.029682274
"New Hampshire","2012",2405,2386,19,0.992099792,0.007900208
"New Hampshire","2013",2402,2393,9,0.996253122,0.003746878
"New Hampshire","2014",2403,2395,8,0.996670828,0.003329172
"New Hampshire","2015",2392,2379,13,0.994565217,0.005434783
"New Hampshire","2016",2452,2442,10,0.995921697,0.004078303
"New Hampshire","2017",2488,2482,6,0.997588424,0.002411576
"New Hampshire","2018",2379,2373,6,0.997477932,0.002522068
"New Hampshire","2019",2465,2464,1,0.99959432,0.00040568
"New Jersey","2010",5572,5313,259,0.953517588,0.046482412
"New Jersey","2011",5599,5395,204,0.963564922,0.036435078
"New Jersey","2012",5396,5187,209,0.961267606,0.038732394
"New Jersey","2013",5421,5369,52,0.990407674,0.009592326
"New Jersey","2014",5445,5392,53,0.990266299,0.009733701
"New Jersey","2015",5470,5361,109,0.980073126,0.019926874
"New Jersey","2016",5513,5426,87,0.984219118,0.015780882
"New Jersey","2017",5589,5533,56,0.989980318,0.010019682
"New Jersey","2018",5505,5430,75,0.986376022,0.013623978
"New Jersey","2019",5514,5489,25,0.995466086,0.004533914
"New Mexico","2010",4940,4893,47,0.99048583,0.00951417
"New Mexico","2011",4929,4822,107,0.978291743,0.021708257
"New Mexico","2012",4903,4805,98,0.980012237,0.019987763
"New Mexico","2013",4960,4871,89,0.982056452,0.017943548
"New Mexico","2014",4868,4836,32,0.993426459,0.006573541
"New Mexico","2015",4644,4625,19,0.995908699,0.004091301
"New Mexico","2016",4556,4533,23,0.994951712,0.005048288
"New Mexico","2017",4564,4493,71,0.984443471,0.015556529
"New Mexico","2018",4570,4451,119,0.973960613,0.026039387
"New Mexico","2019",4529,4475,54,0.988076838,0.011923162
"New York","2010",12204,11978,226,0.981481481,0.018518519
"New York","2011",11809,11677,132,0.988822085,0.011177915
"New York","2012",11585,11380,205,0.982304704,0.017695296
"New York","2013",10340,10296,44,0.995744681,0.004255319
"New York","2014",10356,10329,27,0.997392816,0.002607184
"New York","2015",10260,10182,78,0.992397661,0.007602339
"New York","2016",10260,10169,91,0.991130604,0.008869396
"New York","2017",10972,10904,68,0.993802406,0.006197594
"New York","2018",10908,10802,106,0.990282362,0.009717638
"New York","2019",10792,10760,32,0.997034841,0.002965159
"North Carolina","2010",13005,12738,267,0.979469435,0.020530565
"North Carolina","2011",13155,12925,230,0.982516154,0.017483846
"North Carolina","2012",13181,13024,157,0.988088916,0.011911084
"North Carolina","2013",13472,13457,15,0.99888658,0.00111342
"North Carolina","2014",13740,13726,14,0.998981077,0.001018923
"North Carolina","2015",12622,12601,21,0.998336238,0.001663762
"North Carolina","2016",11185,11107,78,0.993026375,0.006973625
"North Carolina","2017",12308,12254,54,0.99561261,0.00438739
"North Carolina","2018",11495,11451,44,0.996172249,0.003827751
"North Carolina","2019",11781,11764,17,0.998556999,0.001443001
"North Dakota","2010",3100,3089,11,0.996451613,0.003548387
"North Dakota","2011",3182,3172,10,0.996857322,0.003142678
"North Dakota","2012",3292,3279,13,0.996051033,0.003948967
"North Dakota","2013",3271,3252,19,0.994191379,0.005808621
"North Dakota","2014",3281,3262,19,0.994209083,0.005790917
"North Dakota","2015",3649,3584,65,0.982186901,0.017813099
"North Dakota","2016",3630,3626,4,0.998898072,0.001101928
"North Dakota","2017",3945,3925,20,0.994930292,0.005069708
"North Dakota","2018",3599,3581,18,0.994998611,0.005001389
"North Dakota","2019",3647,3642,5,0.99862901,0.00137099
"Ohio","2010",14065,13540,525,0.962673303,0.037326697
"Ohio","2011",13607,13100,507,0.962739766,0.037260234
"Ohio","2012",13359,12748,611,0.954263044,0.045736956
"Ohio","2013",12933,12827,106,0.991803912,0.008196088
"Ohio","2014",12954,12834,120,0.990736452,0.009263548
"Ohio","2015",13013,12895,118,0.990932145,0.009067855
"Ohio","2016",12980,12831,149,0.988520801,0.011479199
"Ohio","2017",13449,13389,60,0.995538702,0.004461298
"Ohio","2018",13476,13371,105,0.99220837,0.00779163
"Ohio","2019",13609,13560,49,0.996399442,0.003600558
"Oklahoma","2010",7743,7695,48,0.993800852,0.006199148
"Oklahoma","2011",7620,7153,467,0.938713911,0.061286089
"Oklahoma","2012",7316,6974,342,0.953253144,0.046746856
"Oklahoma","2013",7054,6974,80,0.988658917,0.011341083
"Oklahoma","2014",7402,7373,29,0.99608214,0.00391786
"Oklahoma","2015",7033,7025,8,0.998862505,0.001137495
"Oklahoma","2016",8026,8012,14,0.998255669,0.001744331
"Oklahoma","2017",8702,8674,28,0.996782349,0.003217651
"Oklahoma","2018",8343,8264,79,0.990530984,0.009469016
"Oklahoma","2019",7129,7118,11,0.998457007,0.001542993
"Oregon","2010",8586,8561,25,0.997088283,0.002911717
"Oregon","2011",8209,8113,96,0.988305518,0.011694482
"Oregon","2012",8270,8204,66,0.992019347,0.007980653
"Oregon","2013",8286,8095,191,0.976949071,0.023050929
"Oregon","2014",7947,7869,78,0.990184975,0.009815025
"Oregon","2015",7957,7800,157,0.980268946,0.019731054
"Oregon","2016",7556,7548,8,0.998941239,0.001058761
"Oregon","2017",7903,7589,314,0.960268253,0.039731747
"Oregon","2018",7874,7624,250,0.968249936,0.031750064
"Oregon","2019",8292,8245,47,0.994331886,0.005668114
"Pennsylvania","2010",12565,12012,553,0.955988858,0.044011142
"Pennsylvania","2011",13169,12829,340,0.974181791,0.025818209
"Pennsylvania","2012",13522,13019,503,0.962801361,0.037198639
"Pennsylvania","2013",14058,13870,188,0.986626832,0.013373168
"Pennsylvania","2014",14017,13876,141,0.989940786,0.010059214
"Pennsylvania","2015",13723,13534,189,0.986227501,0.013772499
"Pennsylvania","2016",13752,13592,160,0.988365329,0.011634671
"Pennsylvania","2017",13750,13653,97,0.992945455,0.007054545
"Pennsylvania","2018",13990,13884,106,0.992423159,0.007576841
"Pennsylvania","2019",14456,14384,72,0.995019369,0.004980631
"Puerto Rico","2010",3051,3048,3,0.999016716,0.000983284
"Puerto Rico","2011",2967,2967,0,1,0
"Puerto Rico","2012",3408,3408,0,1,0
"Puerto Rico","2013",3290,3279,11,0.996656535,0.003343465
"Puerto Rico","2014",2900,2898,2,0.999310345,0.000689655
"Puerto Rico","2015",2960,2955,5,0.998310811,0.001689189
"Puerto Rico","2016",2844,2813,31,0.989099859,0.010900141
"Puerto Rico","2017",2158,2147,11,0.994902688,0.005097312
"Puerto Rico","2018",1907,1884,23,0.987939171,0.012060829
"Puerto Rico","2019",2659,2634,25,0.990597969,0.009402031
"Rhode Island","2010",930,909,21,0.977419355,0.022580645
"Rhode Island","2011",944,925,19,0.979872881,0.020127119
"Rhode Island","2012",1028,1000,28,0.972762646,0.027237354
"Rhode Island","2013",1087,1066,21,0.980680773,0.019319227
"Rhode Island","2014",1093,1090,3,0.997255261,0.002744739
"Rhode Island","2015",1083,1068,15,0.986149584,0.013850416
"Rhode Island","2016",1081,1068,13,0.987974098,0.012025902
"Rhode Island","2017",1076,1062,14,0.986988848,0.013011152
"Rhode Island","2018",1080,1061,19,0.982407407,0.017592593
"Rhode Island","2019",1068,1066,2,0.998127341,0.001872659
"South Carolina","2010",6520,6452,68,0.989570552,0.010429448
"South Carolina","2011",5994,5910,84,0.985985986,0.014014014
"South Carolina","2012",5324,5299,25,0.995304282,0.004695718
"South Carolina","2013",5628,5626,2,0.999644634,0.000355366
"South Carolina","2014",5577,5571,6,0.998924153,0.001075847
"South Carolina","2015",5617,5613,4,0.999287876,0.000712124
"South Carolina","2016",5895,5861,34,0.9942324,0.0057676
"South Carolina","2017",5819,5813,6,0.998968895,0.001031105
"South Carolina","2018",5837,5832,5,0.999143396,0.000856604
"South Carolina","2019",5228,5212,16,0.996939556,0.003060444
"South Dakota","2010",3037,3032,5,0.998353638,0.001646362
"South Dakota","2011",3006,3003,3,0.999001996,0.000998004
"South Dakota","2012",3040,3024,16,0.994736842,0.005263158
"South Dakota","2013",3019,3018,1,0.999668764,0.000331236
"South Dakota","2014",3025,3022,3,0.999008264,0.000991736
"South Dakota","2015",3387,3370,17,0.994980809,0.005019191
"South Dakota","2016",3396,3390,6,0.998233216,0.001766784
"South Dakota","2017",3395,3385,10,0.997054492,0.002945508
"South Dakota","2018",3392,3378,14,0.995872642,0.004127358
"South Dakota","2019",3386,3376,10,0.997046663,0.002953337
"Tennessee","2010",7110,6827,283,0.960196906,0.039803094
"Tennessee","2011",7122,6893,229,0.967846111,0.032153889
"Tennessee","2012",6562,6322,240,0.963425785,0.036574215
"Tennessee","2013",6716,6700,16,0.99761763,0.00238237
"Tennessee","2014",6655,6603,52,0.992186326,0.007813674
"Tennessee","2015",6345,6309,36,0.994326241,0.005673759
"Tennessee","2016",5941,5870,71,0.98804915,0.01195085
"Tennessee","2017",7117,7090,27,0.996206267,0.003793733
"Tennessee","2018",7814,7774,40,0.994880983,0.005119017
"Tennessee","2019",7908,7879,29,0.996332828,0.003667172
"Texas","2010",15255,14962,293,0.980793183,0.019206817
"Texas","2011",15073,14436,637,0.957739004,0.042260996
"Texas","2012",14722,14306,416,0.97174297,0.02825703
"Texas","2013",14799,14535,264,0.982160957,0.017839043
"Texas","2014",14621,14515,106,0.992750154,0.007249846
"Texas","2015",14344,14100,244,0.982989403,0.017010597
"Texas","2016",14655,14553,102,0.993039918,0.006960082
"Texas","2017",16321,16061,260,0.984069604,0.015930396
"Texas","2018",17016,16629,387,0.9772567,0.0227433
"Texas","2019",16923,16669,254,0.984990841,0.015009159
"Utah","2010",3998,3829,169,0.957728864,0.042271136
"Utah","2011",4653,4499,154,0.966903073,0.033096927
"Utah","2012",5065,4934,131,0.974136229,0.025863771
"Utah","2013",4969,4632,337,0.932179513,0.067820487
"Utah","2014",4997,4912,85,0.982989794,0.017010206
"Utah","2015",4780,4694,86,0.982008368,0.017991632
"Utah","2016",4553,4435,118,0.974083022,0.025916978
"Utah","2017",4717,4540,177,0.96247615,0.03752385
"Utah","2018",5217,5051,166,0.968180947,0.031819053
"Utah","2019",5093,5021,72,0.985862949,0.014137051
"Vermont","2010",1094,1089,5,0.995429616,0.004570384
"Vermont","2011",1096,1087,9,0.991788321,0.008211679
"Vermont","2012",1211,1206,5,0.995871181,0.004128819
"Vermont","2013",1209,1204,5,0.995864351,0.004135649
"Vermont","2014",1211,1208,3,0.997522709,0.002477291
"Vermont","2015",1207,1204,3,0.997514499,0.002485501
"Vermont","2016",1206,1205,1,0.999170813,0.000829187
"Vermont","2017",1212,1211,1,0.999174917,0.000825083
"Vermont","2018",1212,1211,1,0.999174917,0.000825083
"Vermont","2019",1199,1199,0,1,0
"Virgin Islands","2010",483,480,3,0.99378882,0.00621118
"Virgin Islands","2011",481,475,6,0.987525988,0.012474012
"Virgin Islands","2012",485,485,0,1,0
"Virgin Islands","2013",192,192,0,1,0
"Virgin Islands","2014",157,157,0,1,0
"Virgin Islands","2015",147,147,0,1,0
"Virgin Islands","2016",115,115,0,1,0
"Virgin Islands","2017",93,93,0,1,0
"Virgin Islands","2018",207,206,1,0.995169082,0.004830918
"Virgin Islands","2019",426,426,0,1,0
"Virginia","2010",9275,9077,198,0.978652291,0.021347709
"Virginia","2011",9600,9455,145,0.984895833,0.015104167
"Virginia","2012",9623,9480,143,0.985139769,0.014860231
"Virginia","2013",8962,8948,14,0.998437849,0.001562151
"Virginia","2014",9127,9115,12,0.99868522,0.00131478
"Virginia","2015",9135,9117,18,0.998029557,0.001970443
"Virginia","2016",8667,8630,37,0.995730933,0.004269067
"Virginia","2017",9380,9301,79,0.991577825,0.008422175
"Virginia","2018",9136,9126,10,0.998905429,0.001094571
"Virginia","2019",9179,9169,10,0.998910557,0.001089443
"Washington","2010",10612,10594,18,0.998303807,0.001696193
"Washington","2011",10444,10384,60,0.994255075,0.005744925
"Washington","2012",10407,10309,98,0.990583261,0.009416739
"Washington","2013",10052,9991,61,0.993931556,0.006068444
"Washington","2014",9957,9904,53,0.994677112,0.005322888
"Washington","2015",10029,9886,143,0.98574135,0.01425865
"Washington","2016",10114,10086,28,0.99723156,0.00276844
"Washington","2017",10397,10081,316,0.969606617,0.030393383
"Washington","2018",10672,10366,306,0.971326837,0.028673163
"Washington","2019",10960,10932,28,0.997445255,0.002554745
"West Virginia","2010",4678,4565,113,0.975844378,0.024155622
"West Virginia","2011",4489,4423,66,0.985297394,0.014702606
"West Virginia","2012",4340,4265,75,0.982718894,0.017281106
"West Virginia","2013",4295,4284,11,0.997438882,0.002561118
"West Virginia","2014",4215,4209,6,0.998576512,0.001423488
"West Virginia","2015",4207,4189,18,0.995721417,0.004278583
"West Virginia","2016",4166,4153,13,0.996879501,0.003120499
"West Virginia","2017",4882,4864,18,0.996312986,0.003687014
"West Virginia","2018",4910,4880,30,0.99389002,0.00610998
"West Virginia","2019",4867,4847,20,0.995890692,0.004109308
"Wisconsin","2010",7996,7851,145,0.981865933,0.018134067
"Wisconsin","2011",7387,7244,143,0.980641668,0.019358332
"Wisconsin","2012",8209,7813,396,0.951760263,0.048239737
"Wisconsin","2013",8381,8297,84,0.98997733,0.01002267
"Wisconsin","2014",7959,7845,114,0.985676593,0.014323407
"Wisconsin","2015",8170,8079,91,0.988861689,0.011138311
"Wisconsin","2016",8015,7899,116,0.985527137,0.014472863
"Wisconsin","2017",8713,8648,65,0.992539883,0.007460117
"Wisconsin","2018",8805,8714,91,0.989664963,0.010335037
"Wisconsin","2019",8427,8408,19,0.997745342,0.002254658
"Wyoming","2010",5331,5315,16,0.996998687,0.003001313
"Wyoming","2011",5662,5617,45,0.992052278,0.007947722
"Wyoming","2012",5860,5776,84,0.985665529,0.014334471
"Wyoming","2013",5742,5724,18,0.996865204,0.003134796
"Wyoming","2014",5896,5879,17,0.997116689,0.002883311
"Wyoming","2015",5879,5857,22,0.996257867,0.003742133
"Wyoming","2016",5938,5933,5,0.999157966,0.000842034
"Wyoming","2017",5636,5592,44,0.992193045,0.007806955
"Wyoming","2018",5959,5931,28,0.995301225,0.004698775
"Wyoming","2019",6196,6174,22,0.996449322,0.003550678
